step,days,C,P,E,N,H,R,total
0,0,474,10,431,189,839,65,2008
1440,1,489,10,422,194,836,68,2019
2880,2,516,11,411,178,818,73,2007
4320,3,532,15,410,189,795,67,2008
5760,4,559,15,426,184,801,70,2055
7200,5,586,19,411,178,803,72,2069
8640,6,603,20,424,172,821,70,2110
10080,7,630,18,413,165,791,74,2091
11520,8,645,23,433,161,769,73,2104
12960,9,661,25,433,155,772,77,2123
